...####################################################################################################################################################
......#..............#..#..#..#..#..#..#........#........#.................#....................#...........#..#.....#........#........#..#...........#
#..#..#######..#######..#..#..#..#..#..#..##########..#..#######..####..#..################..####..####..####..####..#..####..#..#######..#..####..#..#
#..#.....#.....#..#..............#..............#.....#..#.....#.....#..#.....#..#..#........#.....#...........#.....#.....#..............#..#..#..#..#
####..#######..#..#..####..#..#..####..####..#..#..##########..#..#######..#..#..#..#..#############..####..#######..####..#######..##########..####..#
#.....#.....#...........#..#..#..#.....#.....#..#........#..#...........#..#........#..#........#.....#..............#.....#..#.....#..#..#..#..#..#..#
#..#######..####..#..#..####..#######..#############..####..#..#..#..##########..####..#..#############..##########..#..####..#..#..#..#..#..#..#..#..#
#..#...........#..#..#.....#..#..........................#.....#..#..#.......................#.....#..#.....#..#........#.....#..#..............#.....#
#..#..#..################..####..####..####..################..#..####..####..#######..#..#..####..#..####..#..##########..#######..################..#
#.....#.....#..#..#........#........#..#..#..#........#..#..#..#..#........#..#..#..#..#..#..#........#..#.....#.....#........#...........#........#..#
#######..#..#..#..####..##########..#..#..#..#..#######..#..#######..#..####..#..#..#..####..####..#..#..#..####..#..####..#######..####..#..#######..#
#........#..#..#..#........#.....#..#..#........#........#.....#.....#..#.....#.....#..#.....#.....#.....#.....#..#..#..#.....#.....#.................#
####..####..#..#..####..####..#..#######..#..####..####..#..#..#..################..####..####..##########..#..#..#..#..#..#############..#######..####
#.....#........#.....#..#.....#...........#........#..#..#..#....................#..#..#..............#..#..#.....#...........#..#.....#..#........#..#
#..#..#..#..####..#..#..#..##########..#..####..####..#..#..#############..####..#..#..####..#######..#..#..##########..####..#..#..####..#######..#..#
#..#..#..#..#.....#.................#..#.....#..#.....#..............#.....#........#.....#..#...........#........#..#.....#..#..............#..#..#..#
#..#..#..#..#######..#..#..#..#..###################..####..#..#..####..################..#..#######..####..#######..#..#..####..#..####..#..#..####..#
#..#..#..#.....#..#..#..#..#..#..#..#..#..#..#.....#........#..#..#........#.....#...........#........#........#..#..#..#..#..#..#.....#..#..#..#..#..#
#######..#..####..#..####..#######..#..#..#..#..####..#######..#############..################..#..####..####..#..#..#######..##########..#..#..#..#..#
#.....#..#..............#..#..#....................#..#........#...........#...........#.....#..#..#..#..#..#..#..#...........#..#.....#..#.....#..#..#
####..#..#..#######..####..#..#..#..#..#..####..#..####..####..#######..#..####..####..####..#..#..#..#..#..####..#..####..####..####..##########..#..#
#........#..#..#.....#........#..#..#..#.....#..#..#........#..#........#..#..#..#..#..#........#.....#.....#...........#.....#.....#.....#........#..#
#######..####..####..#######..##########..####..####..#..#..##########..#..#..#..#..#..##########..####..####..#############..#..#..#..#..#..#######..#
#..#..#.....#..#........#........#........#...........#..#.....#.....#..#...........#..#........#..#..#.................#..#..#..#..#..#..#..#.....#..#
#..#..#..#..#..####..####..#..#######..####..#..####..#..#######..####..####..#..#######..#######..#..####..#############..#######..#..#..#..#..####..#
#..#.....#........#..#.....#..#.....#..#.....#.....#..#.....#.....#..#..#.....#.....#........#........#.....#..............#..#........#.....#.....#..#
#..#..####..####..#############..#######..##########..##########..#..#..####..##########..####..#######..#..#..#######..####..#############..#..#..#..#
#.....#.....#..#..#.....#.....#.....#...........#...........#.....#........#..#..#...........#..#.....#..#.....#.....#.....#..............#.....#..#..#
#############..#..#..####..#..#..######################..####..#..##########..#..#..#..#######..#..##########..#..#############..####..####..####..#..#
#..#...........#..#.....#..#..#.....#...........#.....#........#..#..#...........#..#.....#..#.....#..#..#........#..#.....#.....#...........#........#
#..####..##########..#..####..#..####..####..####..####..####..####..####..#######..#######..#..####..#..####..####..####..####..#######..#######..#..#
#..#.....#..#..#..#..#..#..#.....#.....#.....#..............#.....#........#.....#.....#....................#........#.....#........#..#.....#..#..#..#
#..####..#..#..#..#..#..#..#..#..####..#######..#########################..####..#..#..####..#######..####..#..##########..#..#######..#..####..####..#
#..#..............#..#..#..#..#.....#........#..#..............#.....#..............#.....#.....#..#..#........#.....#.....#..#........#...........#..#
#..#..#..#..#..#######..#..#..#############..#..##########..####..#######..#######..####..#..####..####..#######..#######..####..#######..####..#..#..#
#.....#..#..#..#.....#.....#........#..#.................#..#........#.....#.....#.....#........#.....#..#........#..#..#.....#..#.....#..#.....#..#..#
####..#######..####..#..####..####..#..#..#######..#######..#######..#######..#..#..#######..####..#..#..#..#..####..#..#..#..#..#..####..#############
#........#.....#..#..#.....#..#...........#..#..#.....#........#..#..#..#.....#........#..#.....#..#........#........#.....#...........#...........#..#
##########..####..#..#..#######..#..#######..#..####..####..#..#..#..#..#..#..####..####..####..####..#..####..####..####..#######..#######..#######..#
#.....#...........#...........#..#..#..#.....#..............#.....#........#..#........#..#.....#.....#.....#..#...........#.....#........#.....#.....#
#..#######..################..####..#..#..#..####..####..#..#..#######..####..##########..####..####..#..##########..####..####..##########..#######..#
#...........#....................#.....#..#........#.....#..#..#.....#..#.................#..#..#.....#..#.....#..#.....#.....#...........#..#........#
####..##########..#..#..#..###################..#############..#..####..#############..####..#############..#..#..#######..#######..#..####..####..####
#........#.....#..#..#..#.....#.....#...........#...........#..#..#..#..#..#........#..#........#..#..#.....#.....#.................#.................#
#..##########..#..#..#..#..#..#..#######..#..#..#..#############..#..#..#..####..##########..####..#..#######..#..##########..#######..#..#..##########
#...........#.....#..#..#..#...........#..#..#...........#...........#.....#...................................#........#..#..#..#.....#..#..#........#
#..####..####..#######..##########..#..####..#..##########..#######..####..#..#..####..####..#..####..#..####..####..#..#..####..#..##########..#..#..#
#.....#.....#.....#.....#...........#........#..#........#........#..#.....#..#.....#..#.....#..#.....#..#.....#..#..#..#..#..#..............#..#..#..#
#######..####..#..#..#############..#######..####..#######..####..####..####..#############..#######..#######..#..#######..#..#..####..#############..#
#..............#..#.....#..#..#...........#..#...........#.....#.......................#........#...........#.....#...........#..#.....#..#.....#.....#
#..##########..##########..#..#######..##########..#######..#..#..#..####..#..######################..#######..####..#..#######..#..#..#..#..#######..#
#.....#.....#..#..#........#.....#.....#..#..#........#.....#..#..#..#.....#..#..#.....#..#........#..#..#........#..#...........#..#.................#
#..####..####..#..#..####..#..####..#..#..#..#..####..#######..#############..#..####..#..#######..####..#..#######..####..####..####..####..####..####
#.....#.....#..#........#..#..#.....#..#.....#.....#..#.....#.....#..#..#.....#..#.....#..#.......................#..#.....#..#..#........#..#..#.....#
#..#######..#..#..####..#..#..##########..####..#######..####..#..#..#..#..#..#..####..#..#############..#..#..####..#..#..#..#..####..#######..####..#
#........#.....#.....#..#.....#.....#..............#........#..#..#........#...........#..#.....#........#..#..#..#..#..#..#.....#.................#..#
#######..##########..####..####..#..#..#..#..#..####..###################..#..##########..####..#..#..####..####..###############################..####
#..#..#........#.....#..#..#.....#..#..#..#..#.....#........#........#.....#..#..#.................#..#.....#...........#.....#.....#........#.....#..#
#..#..####..#######..#..####..#######..#..################..#..####..#######..#..##########..##########..#######..#..#..####..#..#######..####..####..#
#.....#.....#........#.....#...........#.....#..#..#...........#.....#........#..#...........#.................#..#..#.................#........#..#..#
#..#######..#..#..#..####..#..#######..####..#..#..#..###################..#..#..#######..#######..####..#######..####..####..##########..#######..#..#
#..#..#..#.....#..#..............#........#.....#........#..............#..#..#........#........#.....#..#.....#..#.....#.....#.....#.....#...........#
#..#..#..#..####..####..####..##########..#..#..#..##########..###################..#..#..#######..#..#..#..#############..#######..#..#..#######..####
#........#.....#..#.....#..#..#.....#..#..#..#........#...........#........#..#..#..#..#..#..#.....#..#.....#.....#..#..#..#..#..#.....#..#.....#..#..#
#..####..####..####..#..#..#..####..#..#..##########..#..##########..#..####..#..####..#..#..####..#..#######..####..#..#..#..#..####..#######..#..#..#
#..#.....#........#..#..#.....#.....#........#.....#..#..............#..#..#..............#........#.....#..#..#........#........#....................#
#######..#..####..#############..##########..####..#..#..#..##########..#..#..#..####..#######..#..#..#..#..#..#..####..#..####..####..#######..####..#
#.....#..#..#..............#.....#...........#.....#.....#..#.....#........#..#.....#..#..#.....#..#..#..#..#.....#..#.....#........#..#..#.....#..#..#
####..#..#############..#######..#######..####..#######..####..#######..####..#######..#..#..####..#######..#######..#..#..#..####..#..#..####..#..#..#
#...........#..#...........#..............#........#.....#........#.....#........#..#.....#.....#..#..#...........#.....#..#..#..#..#..#..#..#..#..#..#
#..####..####..#..####..#..#..#..####..####..#..#######..####..####..####..####..#..#############..#..##########..####..#..####..#..#..#..#..#..#..####
#.....#...........#.....#..#..#.....#........#..#...........#........#.....#.................#.......................#..#.....#...........#...........
####################################################################################################################################################..
