#######################################################################################################################################################
#.....#....................#...........#..........................#..............#........#................................#........#.................#
####..#..##########..####..#..#######..#..##########..####..#######..#######..#..#..#######..####..##########..#############..#..####..#..##########..#
#.....#.....#..#.....#.....#........#........#.....#.....#..#.....#..#........#..#..#.....#..#.....#..#.....#..#...........#..#........#........#..#..#
#..#######..#..#..####..##########..##########..#..#######..#..#..#..#..#######..#..#..#..#..#..####..#..#..#..#..#######..#..################..#..#..#
#..............#.....#.....#.....#.....#..#.....#...........#..#..#..#.....#.....#.....#.....#.....#..#..#.....#..#.....#..#........#........#..#..#..#
#..################..#######..#..####..#..#..################..#..#..####..####..################..#..#..#######..#..####..#######..#..#######..#..#..#
#.....#..#...........#........#........#..#.................#..#..#..#..#.....#........#........#..#.....#..#.....#.....#...........#........#..#.....#
####..#..#..#######..#..################..################..#..#..#..#..####..#######..#..####..#..#..####..#..#######..###################..#..#######
#........#..#..#.....#..#.....#........#..............#..#.....#...........#..#.....#..#..#..#.....#........#...........#........#...........#........#
##########..#..#..####..#..#..#..####..####..#..####..#..###################..#..####..#..#..#######..################..#..####..#..#######..#######..#
#...........#.....#.....#..#..#..#..#.....#..#.....#.................#........#.....#..#..#...........#...........#.....#..#..#..#..#.....#..#........#
#..##########..####..####..#..#..#..####..#..####..################..#..#######..#..#..#..##########..#..####..####..####..#..#..#..####..#..#..####..#
#........#.....#..#.....#..#.....#.....#..#.....#..#........#........#........#..#..#.....#........#..#.....#.....#........#.....#..#.....#..#..#..#..#
#..####..####..#..####..#..#######..####..####..#..#..#######..#############..####..####..#..####..####..#######..##########..####..#..####..#..#..#..#
#..#..#.....#........#.....#.....#........#..#..#..#....................#..#.....#........#.....#........#.....#..#........#.....#..#........#..#..#..#
#..#..####..###################..#..#######..#..#..####..#############..#..####..#######..####..##########..#..#..#..####..####..#..##########..#..#..#
#.....#.....#.................#..#..#...........#.....#..#...........#.....#..#........#.....#..#.....#.....#.....#..#..#.....#..#..#........#..#.....#
####..#..#..#..##########..#..#..#..####..##########..####..#######..####..#..#######..####..#..#..#..#..##########..#..#..#..#..#..#..####..#..#######
#.....#..#..#..#........#..#..#..#.....#..#........#.....#........#.....#..#........#.....#..#.....#..#.................#..#..#.....#..#.....#........#
#..####..####..#..####..#..#..#..####..####..####..####..####..#######..#..####..#######..##########..##########..#######..#######..#..#..##########..#
#..#..#........#.....#.....#........#........#..#.....#.....#..#........#.....#........#........#.....#........#..#........#........#..#..#...........#
#..#..#############..#############..##########..####..#..####..#..##########..#######..#######..#..####..####..#..#..#######..#######..#..#..##########
#..#........#.....#..#.....#.....#..#...........#.....#..#.....#..#..#....................#.....#..#..#..#.....#..#.....#.....#.....#..#..#...........#
#..#..####..#..#..#..#..#..####..#..#..##########..####..#..####..#..#..##########..#######..####..#..#..####..####..#..#..#######..#..#..#######..#..#
#..#..#.....#..#.....#..#.....#........#........#..#........#.....#.....#........#..#........#.....#..#.....#.....#..#..#..#........#..#..#.....#..#..#
#..#..#..####..#..####..####..##########..####..#..#..#######..##########..####..####..#..####..####..####..####..####..#..#..#..####..#..#..#..####..#
#.....#..#.....#..#.....#..#........#.....#..#.....#........#...........#.....#.....#..#..#.....#........#..#..#.....#..#.....#..#.....#.....#.....#..#
#######..#..####..#..####..#######..#..####..#############..##########..#..#######..#..#..#..####..####..#..#..####..#..#######..#..#############..#..#
#.....#..#..#.....#........#.....#..#..............#.....#..#..#.....#.....#........#..#..#.....#..#.....#..#........#........#..#.....#........#.....#
#..####..#..#############..#..#..#..#############..#..#..#..#..#..#..#######..####..#..#######..#..#######..####..####..#######..####..#..####..####..#
#........#..#...........#..#..#..#..............#..#..#..#.....#..#........#..#.....#........#.....#.....#.....#.....#..#.....#.....#........#..#.....#
#..#######..#..#######..#..#..#######..#######..#..#..#..####..#..#######..#..#..##########..####..#..#..####..####..#..#..#..####..##########..#..####
#.....#..#..#..#.....#..#..#.....#.....#........#..#..#.....#..#.....#........#........#..#........#..#..#.....#.....#.....#..#.....#...........#..#..#
####..#..#..#..####..#..#..#..#..#..#..##########..#..####..#######..################..#..#######..#..#..#..####..####..####..#..####..##########..#..#
#..#.....#.....#.....#..#..#..#..#..#..#...........#..#..#...........#.....#........#.....#.....#..#..#..#..#.....#........#.....#..#.....#.....#..#..#
#..####..#######..#..#..#..####..#..####..##########..#..#######..####..#..#..####..#######..#..#..#..#..#..#..################..#..####..#..#..#..#..#
#.....#...........#..#..#.....#..#..............#.....#........#..#.....#..#.....#...........#..#..#..#.....#.................#.....#.....#..#.....#..#
####..#############..#..####..#..#############..#..#..####..####..#..####..#..#..#############..####..######################..#######..##########..#..#
#.....#..............#...........#.....#.....#..#..#.....#........#.....#..#..#..#...........#.....#.....#........#........#........#...........#.....#
#..####..################..#######..#..####..#..#######..#..##########..#..####..#..#######..####..####..#..#..#..#..#############..#..#######..####..#
#..............#........#.....#.....#.....#..#.....#.....#..#..#.....#..#........#..#.....#..#..#........#..#..#..#...........#.....#.....#.....#.....#
#..#############..####..#..####..#######..#..####..#..####..#..#..#..#..##########..#..####..#..#############..#..##########..#..#######..#..####..####
#........#........#..#..#..#.....#.....#..#........#..#.....#..#..#..#..#...........#..............#...........#...........#..#..#.....#..#.....#..#..#
#######..#..#######..#..####..####..#..#..#######..#..#..####..#..#..#..##########..#############..#..#..################..#..#..#..#..#######..#..#..#
#..#.....#.....#........#.....#.....#...........#.....#........#..#.....#........#...........#.....#..#.....#..#........#..#..#.....#..#.....#..#.....#
#..#..#######..#..#######..#..################..################..####..#..####..#..#######..#######..####..#..#..#..####..#..#######..#..#..#..#######
#........#.....#.....#.....#..#........#..#.....#...........#.....#.....#..#.....#........#...........#.....#..#..#........#........#.....#..#..#.....#
#..#######..#######..####..#..#..####..#..#..####..#######..#..##########..#..###################..####..####..#..##########..####..#######..#..#..#..#
#.....#.....#.....#........#..#..#..#..#...........#.....#..#..............#.....#..............#.....#..#..#.....#........#.....#..#.....#..#.....#..#
####..#..####..##########..####..#..#..#############..#..#..################..#..#..##########..#..####..#..#..####..####..####..#..####..#..#######..#
#.....#.....#...........#..#.....#..#.....#........#..#..#.....#...........#..#...........#..#..#..#.....#..#..#........#.....#..#..#.....#.....#.....#
#..#######..##########..#..#..####..####..#..#..#..#..#..####..#..#######..#..##########..#..#..#..#..####..#..#######..####..#..#..#..#..####..#..####
#.....#..#..#........#.....#........#.....#..#..#.....#.....#..#..#........#..#.....#........#..#..#..#........#........#..#..#..#..#..#..#.....#.....#
####..#..#..#..####..#..##########..#..####..#..##########..#..#..#######..####..#..#######..#..####..#..#######..#######..#..#..#..#..####..#######..#
#........#.....#.....#...........#..#..#.....#..#.....#.....#..#..#.....#........#........#..#..#.....#...........#..............#..#.....#..#.....#..#
#..#############..####..##########..#..####..#..#..#..#######..#..#..#..################..####..#..#############..################..#..#..#..#..#..#..#
#..#..............#.....#...........#.....#..#.....#.....#........#..#..#..............#........#..#.....#........#...........#..#..#..#..#.....#.....#
####..#..################..##########..#..#############..#..#######..#..#..##########..##########..#..#..#######..#..#######..#..#..#..#..##########..#
#.....#..#.....#...........#........#..#..#........#.....#..#..#.....#.....#.....#.....#.....#........#........#..#.....#..#..#..#..#..#...........#..#
#..#######..#..#..##########..####..####..#..####..#..####..#..#..##########..#..#..####..#..#..#######..####..#..####..#..#..#..#..####..##########..#
#.....#.....#.....#........#..#..#........#.....#..#.....#.....#..#...........#..#........#..#..#.....#.....#..#.....#..#..#..#...........#...........#
#..#..#..##########..####..#..#..#######..####..#..#..#..####..#..#############..##########..####..#..####..#..#######..#..#..#############..##########
#..#..#........#........#..#..#........#..#..#..#..#..#........#..#..............#........#..#.....#..#.....#.....#.....#..#.....#...........#........#
#..#..#######..#######..#..#..#..####..#..#..#..#..#######..####..#..####..#######..#######..#..####..##########..#..####..####..#..#############..#..#
#..#........#........#..#..#..#.....#........#..#........#.....#.....#..#..#........#........#.....#...........#..#..#..#.....#..#..#.....#.....#..#..#
#..#######..#######..#..#..#..####..##########..#######..#############..#..#..#######..#..#######..##########..#..#..#..#..#..#..#..#..#..#..#..####..#
#..#........#.....#..#..#..#.....#..#..#.....#.....#.....#...........#.....#........#..#.....#.....#..#........#..#..#.....#..#..#.....#.....#.....#..#
#..#..#######..#..#..####..####..#..#..#..#..####..#..#..#..#..#######..##########..####..#..#..####..#..#######..#..#..####..#..################..#..#
#..#..#........#..#.....#.....#..#.....#..#.....#..#..#..#..#........#..#........#.....#..#...........#.....#.....#..#.....#..#...........#.....#..#..#
#..#..#..#######..####..#..#..#..#######..#..####..#..####..#######..#..####..#..####..###################..#..#..#..#######..####..#######..#..#..#..#
#..#...........#...........#..#...........#........#..............#...........#.....#.......................#..#.................#...........#........#
#######################################################################################################################################################


