#######################################################################################################################################################
#........#........#....................#........#..............#........#.................#........#...........#.....#...........#...........#.....#..#
#..####..#..#..#..####..#############..#######..#..##########..#..#######..##########..#..#..####..#..####..#..####..#..#..#######..####..#..#..#..#..#
#.....#..#..#..#.....#..#........#..#...........#..#........#..#........#...........#..#.....#.....#..#..#..#........#..#.....#.....#..#..#.....#.....#
####..####..#..####..#..#..####..#..#######..####..#..#..####..#..####..#..##########..#######..####..#..#..##########..####..#..####..#..##########..#
#.....#.....#.....#.....#.....#..#..#.....#..#.....#..#........#..#..#.....#.....#.....#.....#..#.....#..#........#.....#..#...........#..#..#.....#..#
#..#..#..#######..####..####..#..#..#..#..#..#..####..##########..#..#######..#..#..####..#..####..####..#######..#..####..##########..#..#..#..#..#..#
#..#..#..#..#.....#........#..#..#.....#.....#..#..#........#..#..#.....#.....#..#........#.....#..............#.....#........#.....#..#..#.....#.....#
#..####..#..#..#############..#..####..#######..#..#######..#..#..#..#..#..####..#############..#############..#############..#..#..####..#..##########
#........#..#..............#..#.....#.....#.....#........#..#........#..#.....#...........#.....#...........#.................#..#........#..#........#
#..#######..#############..#..####..#######..####..#..####..#..#############..##########..#..####..#..#######..##########..####..#############..####..#
#........#..............#..#.....#...........#.....#..#.....#.....#........#.....#..#.....#........#..#........#........#..#.....#.................#..#
#######..#..##########..#..####..#############..####..#..##########..####..#..#..#..#..####..#######..#..#######..####..####..####..################..#
#.....#.....#........#..#.....#..............#.....#..#........#.....#..#..#..#..#..#.....#..#.....#..#.....#..#.....#..#.....#.....#.....#..#........#
#..#######..#..####..####..#..###################..##########..#..####..#..####..#..####..####..#..#..####..#..####..#..#..####..####..#..#..#..####..#
#........#..#..#..#.....#..#....................#..#...........#..#..............#.....#........#..#...........#.....#.....#.....#.....#..#..#.....#..#
#..####..#..#..#..####..#..####..#############..#..#..##########..################..#############..#..##########..#..#######..#######..#..#..####..####
#..#..#.....#..#.....#..#.....#..#.....#...........#..#.....#.................#........#........#..#..#...........#..#........#........#........#.....#
#..#..#######..#..#..#..#######..#..####..##########..#..####..##########..#..#######..#..####..#..####..#######..####..##########..##########..####..#
#..#........#..#..#.....#........#..............#.....#........#........#..#........#..#.....#.....#.....#........#.................#........#.....#..#
#..####..#..#..#..#######..################..####..#############..####..##########..#..####..#######..#..#######..#..###################..#..#..####..#
#........#..#..#...........#.....#........#..#.....#...........#.....#..............#.....#.....#.....#..#.....#..#..#..#........#........#..#..#.....#
##########..#..####..#######..#..#..####..####..####..#######..####..################..#..####..####..####..#..####..#..#..####..#..#..#######..#..####
#........#..#..#..#..#........#........#..#.....#........#..#.....#.....#..#.....#.....#........#.....#.....#.....#..#..#..#.....#..#........#..#.....#
#..#######..#..#..#..#..################..#..##########..#..####..####..#..#..#..#..#############..####..#######..#..#..#..#..####..#######..#..####..#
#...........#..#..#..#.....#..#...........#..............#.....#..#.....#.....#..#..#.....#...........#..#.....#........#..#.....#..#.....#........#..#
#..##########..#..#..####..#..#..#######..################..#..#..#..####..####..#..#..#..#..#######..#..#..#..##########..####..#..#..#..##########..#
#...........#..#.....#..#.....#.....#.....#.....#.....#.....#..#..#.....#.....#.....#..#.....#.....#..#..#..#..#.....#.....#.....#..#..#.....#.....#..#
#############..#..####..####..####..#######..#..#..#..#..####..#..#..#..####..#######..#######..#..#..#..#..#..####..#..####..####..####..####..#..#..#
#..............#...........#.....#...........#.....#..#.....#.....#..#.....#.....#........#.....#..#..#.....#........#..#..#.....#........#.....#..#..#
#..######################..####..###################..####..#############..####..##########..####..#..#..#############..#..####..#######..#..####..#..#
#..#.....#........#.....#.....#.....#........#.....#.....#..#...........#..#.................#.....#.....#..............#........#.....#..#..#..#..#..#
#..#..#..#######..#..#..#..#######..#..#..#..####..####..#..#######..#..#..##########..#######..##########..#############..##########..#..#..#..#..#..#
#.....#.....#.....#..#..#..#........#..#..#........#.....#.....#.....#..#..#........#..#.....#..............#.....#.....#.....#.....#.....#..#..#..#..#
#######..#..#..####..#..#..#..#######..#..#######..#..#######..#..####..#..#..####..####..#..####..##########..#..#..#######..#..#..#######..#..#..#..#
#.....#..#..#........#.....#..#.....#..#..#.....#..#..#........#.....#..#..#.....#........#.....#..#.....#.....#..#...........#..#.....#.....#........#
#..#..####..#..#############..#..#..####..#..#..####..#..##########..#..#..####..#############..####..#..#..####..#######..####..####..#..##########..#
#..#..#.....#...........#..#.....#.....#..#..#........#..#........#..#........#..#.....#.....#........#.....#..#........#........#........#........#..#
#..#..#..#..##########..#..##########..#..#..##########..#..####..#..##########..#..#..#..###################..#######..##########..#######..####..#..#
#..#.....#..#.....#..#..#.....#.....#.....#.....#........#..#........#...........#..#..#........#....................#..#..............#.....#..#..#..#
#..#######..#..#..#..#..####..#..#..####..####..#..#######..##########..##########..#..#..####..#..#..#..#############..#..##########..#..####..#..####
#..#........#..#..#.....#.....#..#...........#..#........#...........#..#...........#..#..#..#.....#..#..#...........#..#..#..#.....#..#..#.....#.....#
#..##########..#..####..#..####..#############..#######..#..#######..#..#..####..####..#..#..#######..####..#######..#..#..#..#..#..####..#..#..####..#
#...........#..#.....#..#.....#.....#..#...........#.....#..#.....#..#..#..#.....#.....#.....#.....#..#.....#.....#..#..#.....#..#........#..#.....#..#
#..#######..#..####..#..####..####..#..#..##########..####..#..#..#..#..####..####..#######..#..#..#..#..####..#..#..#..####..#..################..#..#
#..#........#..#..#..#........#........#...........#..#.....#..#.....#..#.....#..#........#..#..#.....#..#.....#..#..#.....#..#.....#..............#..#
#..#..####..#..#..#..##########..################..#..#..####..#######..#..####..#######..####..#######..#..#######..####..#######..####..##########..#
#..#..#..#..#.....#..............#.................#..#..#..#........#..#..#...........#.....#........#..#.....#...........#.....#.....#........#.....#
#..#..#..#..####..################..#############..#..#..#..#######..#..#..#..#######..####..####..#..#..#..#..#..##########..#..####..#######..#..####
#..#..#.....#..#..#...........#..#........#........#..#........#..#..#..#..#..#.....#.....#.....#..#..#..#..#........#........#.....#..#.....#..#.....#
#..#..####..#..#..#..#..####..#..#######..####..####..#######..#..#..#..#..####..#..#..#..####..####..#..#############..##########..#..#..#..#..####..#
#..#.....#.....#..#..#..#.....#........#.....#.....#..#........#..#..#..#.....#..#.....#..#.....#.....#..#.................#.....#........#........#..#
#######..####..#..####..#..####..####..####..####..#..#######..#..#..#..####..#..#######..#..####..####..#..#############..#..#..###################..#
#.....#..#.....#.....#..#..#........#.....#..#..#..#........#.....#..#.....#..#..#........#.....#.....#.....#...........#..#..#.....#.................#
#..#..#..##########..#..#..####..####..#..#..#..#..#######..####..#..####..#..#..#..##########..####..#######..#######..####..####..#..#############..#
#..#.....#.....#.....#..#.....#..#.....#..#..#........#.....#.....#.....#.....#..#.....#.....#..............#..#..............#........#.....#........#
#..#######..#..#..####..####..####..#######..#..#######..####..####..##########..####..#..####..#######..####..#..######################..####..#######
#..#........#..#..#........#........#........#..#........#..#..#..#..#...........#.....#..#.....#.....#..#.....#..#....................#..#.....#.....#
#..#..#######..#..#..####..#..#######..#######..#..#######..#..#..#..#..####..#######..#..#..####..#..####..#######..################..#..#..#######..#
#.....#.....#.....#..#.....#..#.....#..#........#.....#........#..#.....#.....#.....#.....#..#..#..#.....#........#..#........#.....#..#..#..#.....#..#
#..####..#############..####..#..#..#..#..##########..####..####..#######..####..#..#######..#..#..####..####..#..#..#..####..#..#..#..#..#..#..#..#..#
#.....#.................#.....#..#.....#..#........#.....#........#.....#........#..#...........#..#..#.....#..#........#.....#..#.....#.....#..#..#..#
####..##########..#############..#######..#..##########..#######..#..#..##########..#..##########..#..####..#..################..#######..####..#..#..#
#.....#........#..#..............#.....#.....#........#..#...........#..#........#........#........#..#.....#.....#..............#..#.....#.....#..#..#
#..####..####..#..#..#..##########..#..####..#..#..####..#..##########..####..#..##########..#######..#..####..####..#############..#..####..####..#..#
#........#.....#..#..#..#...........#..#.....#..#.....#..#..#.....#...........#.....#........#........#.....#..#.....#..............#..#........#.....#
##########..####..#..####..##########..#######..####..#..#..#..#..###################..#######..####..####..#..#..####..#######..####..#..####..####..#
#..#........#.....#.....#........#..#.....#........#..#..#..#..#....................#..#...........#..#.....#..#.....#.....#.....#.....#..#..#..#.....#
#..#..##########..####..#######..#..####..#..#######..#..#..#..###################..#..#..##########..#..##########..#######..#..#..####..#..#..#..####
#.....#...........#..#........#..#.....#..#..#........#..#..#........#...........#.....#..#..#........#..#........#........#..#..#.....#.....#..#..#..#
#..####..#######..#..#######..#..####..#..#..#..#######..##########..#..#######..#######..#..#..#######..#..####..#######..#..#######..#######..#..#..#
#........#.................#...........#.....#.......................#........#..............#..............#..............#....................#.....#
#######################################################################################################################################################


